 NO textures/Orange.xpm
 NO textures/Orange.xpm
 SO textures/pink.xpm
 WE textures/yelow.xpm
 EA textures/Grey.xpm
 
 F 220,100,0
 C 225,30,0

11111111111111111111111111
1000000000110000000000001
11110000011100000000000011
10010000000000000000000011111111
11111111101100000111000000000001
10000000001100000111011111111111
11110111111111011100000010001
11110111111111011101010010N01
11000000110101011100000010001
10000000000000001100000010001
10000000000000001101010010001
11000001110101011111011110101
11110111 1110101 101111010001
11111111 1111111 111111111111  