 NO textures/Orange.xpm
 NO textures/Orange.xpm
 SO textures/pink.xpm
 WE textures/yelow.xpm
 EA textures/Grey.xpm
 
 F 220,100,0
 C 225,30,0

11111111    
10000001
100N0001
10111001
111 1111  
