 NO textures/Orange.xpm
 SO textures/pink.xpm
 WE textures/yelow.xpm
 EA textures/Grey.xpm
 
 F 220,100,0
 C 225,30,0

1111111111
1000000001
1000000001
1001111001
1001111001
1000000001
1000N00001
1111111111
