 NO textures/Orange.xpm
 SO textures/pink.xpm
 WE textures/yelow.xpm
 EA textures/Grey.xpm
 
 
 F textures/red.xpm
 C textures/black.xpm

11111111
10000001
10000001
101110W1
111 1111
