 NO textures/wolfenstein/eagle.xpm
 SO textures/wolfenstein/bluestone.xpm
 WE textures/wolfenstein/purplestone.xpm
 EA textures/wolfenstein/wood.xpm
 ST textures/wolfenstein/barrel.xpm
 DO textures/wolfenstein/door.xpm
 SP 0,2,2

 F textures/wolfenstein/colorstone.xpm
 C textures/wolfenstein/greystone.xpm

11111111    
10001001
1E001001
1000D001
10111001
111 1111  
