 NO textures/wolfenstein/eagle.xpm
 SO textures/wolfenstein/bluestone.xpm
 WE textures/wolfenstein/purplestone.xpm
 EA textures/wolfenstein/wood.xpm
 ST textures/wolfenstein/barrel.xpm
 DO textures/wolfenstein/door.xpm

 F textures/wolfenstein/floor-lava.64.xpm
 C textures/wolfenstein/ceiling-red-star.64.xpm

11111111111111111111111111    
10000000000000001000000001
1E000000000000001000111111
1000000000000000D000000001
10000000000000111000000001
10000000000000111000000001
10000000000000111000000001
1000000000000011100000011
1000000000000000111000001111
1000000000000000001000000001
1000000000000000001000000001
1000000000000000111000000001
111111111111111111111111111    
