 NO textures/wolfenstein/eagle.xpm
 SO textures/wolfenstein/bluestone.xpm
 WE textures/wolfenstein/purplestone.xpm
 EA textures/wolfenstein/wood.xpm
 SP textures/wolfenstein/barrel.xpm
 DO textures/wolfenstein/door.xpm
 SP 0,2,2

 F 220,100,0
 C 225,30,0

11111111    
10001001
1E001001
1000D001
10111001
111 1111  
