 NO textures/wolfenstein/eagle.xpm
 SO textures/wolfenstein/bluestone.xpm
 WE textures/wolfenstein/purplestone.xpm
 EA textures/wolfenstein/wood.xpm
 ST textures/wolfenstein/greenlight.xpm
 SP 0,3,3

 F 220,100,0
 C 225,30,0

11111111    
10000001
1E000001
10000001
10111001
111 1111  
