 NO textures/atti/painting--N.xpm
 SO textures/atti/painting--S.xpm
 WE textures/atti/painting--W.xpm
 EA textures/atti/painting--E.xpm
 
 F 220,100,0
 C 225,30,0

11111111    
10000001
10000001
101110N1
111 1111  
