 NO 255,0,0
 SO textures/wolfenstein/bluestone.xpm
 WE textures/wolfenstein/purplestone.xpm
 EA textures/wolfenstein/wood.xpm
 
 F 220,100,0
 C 225,30,0

11111111    
10000001
10000001
101110W1
111 1111  
