 NO textures/wolfenstein/eagle.xpm
 SO textures/wolfenstein/bluestone.xpm
 WE textures/wolfenstein/purplestone.xpm
 EA textures/wolfenstein/wood.xpm
 
 F 220,100,0
 C 225,30,0

11111111                       
1000S001
10000001
10000001
10000001
1ddddddddddddddalalksjdflaksdjfalsdkjfalkjalsdkjfalsdkfjalsdkjfalsdkjfalsdkjkasldkfjasldjff1
10000001
10000001
10000001
11000001
10000001
10000001
10000001
10000001
11111111