 NO textures/atti/painting--N.xpm
 SO textures/atti/painting--S.xpm
 WE textures/atti/painting--W.xpm
 EA textures/atti/painting--E.xpm
 
 F 220,100,0
 C 225,30,0

11111
100s1
10101
11111
