 NO
 SO textures/wolfenstein/bluestone.xpm
 WE textures/wolfenstein/purplestone.xpm
 EA textures/wolfenstein/wood.xpm
 
 F 220,100,0
 C 225,30,0

           11111111                       
           100001011
           1000000001
           100000011
           10000001
           100N0011
           10000001
           11000001
           10000001
            10000001
             10000001
             10000001
             11111111